DDDDDDDDDDDDDDDDD}---------------------------------------------------------------------------{DDDDDDDDDDDDDDDDDDDDDDDDDDDDDDDDDDDDDDDDDDDDDDDDDDDDDDDDDDDDDDDDDDDDDDDDDDDDDDDDDDDDDDDDDDDDD
DDDDDDDDDDDDDDDDD}---------------------------------------------------------------------------{DDDDDDDDDDDDDDDDDDDDDDDDDDDDDDDDDDDDDDDDDDDDDDDDDDDDDDDDDDDDDDDDDDDDDDDDDDDDDDDDDDDDDDDDDDDDD
DDDDDDDDDDDDDDDDD}---------------------------------------------------------------------------{DDDDDDDDDDDDDDDDDDDDDDDDDDDDDDDDDDDDDDDDDDDDDDDDDDDDDDDDDDDDDDDDDDDDDDDDDDDDDDDDDDDDDDDDDDDDD
DDDDDDDDDDDDDDDDD}---------------------------------------------------------------------------{DDDDDDDDDDDDDDDDDDDDDDDDDDDDDDDDDDDDDDDDDDDDDDDDDDDDDDDDDDDDDDDDDDDDDDDDDDDDDDDDDDDDDDDDDDDDD
DDDDDDDDDDDDDDDDD}---------------------------------------------------------------------------{DDDDDDDDDDDDDDDDDDDDDDDDDDDDDDDDDDDDDDDDDDDDDDDDDDDDDDDDDDDDDDDDDDDDDDDDDDDDDDDDDDDDDDDDDDDDD
DDDDDDDDDDDDDDDDD}---------------------------------------------------------------------------{DDDDDDDDDDDDDDDDDDDDDDDDDDDDDDDDDDDDDDDDDDDDDDDDDDDDDDDDDDDDDDDDDDDDDDDDDDDDDDDDDDDDDDDDDDDDD
DDDDDDDDDDDDDDDDD}---------------------------------------------------------------------------{DDDDDDDDDDDDDDDDDDDDDDDDDDDDDDDDDDDDDDDDDDDDDDDDDDDDDDDDDDDDDDDDDDDDDDDDDDDDDDDDDDDDDDDDDDDDD
DDDDDDDDDDDDDDDDD}---------------------------------------------------------------------------{DDDDDDDDDDDDDDDDDDDDDDDDDDDDDDDDDDDDDDDDDDDDDDDDDDDDDDDDDDDDDDDDDDDDDDDDDDDDDDDDDDDDDDDDDDDDD
QZZZZZZZZZZZZZZZZO---------------------------------------------------------------------------{DDDDDDDDDDDDDDDDDDDDDDDDDDDDDDDDDDDDDDDDDDDDDDDDDDDDDDDDDDDDDDDDDDDDDDDDDDDDDDDDDDDDDDDDDDDDD
}--------------------------------------------------------------------------------------------{DDDDDDDDDDDDDDDDDDDDDDDDDDDDDDDDDDDDDDDDDDDDDDDDDDDDDDDDDDDDDDDDDDDDDDDDDDDDDDDDDDDDDDDDDDDDD
}------------------------------------------------------------------------------------2-------{DDDDDDDDDDDDDDDDDDDDDDDDDDDDDDDDDDDDDDDDDDDDDDDDDDDDDDDDDDDDDDDDDDDDDDDDDDDDDDDDDDDDDDDDDDDDD
}-----------------------------------------------------------------------------------LGGGGR---{DDDDDDDDDDDDDDDDDDDDDDDDDDDDDDDDDDDDDDDDDDDDDDDDDDDDDDDDDDDDDDDDDDDDDDDDDDDDDDDDDDDDDDDDDDDDD
}-----------------------------------------------------------------------------------{DDDD}---{DDDDDDDDDDDDDDDDDDDDDDDDDDDDDDDDDDDDDDDDDDDDDDDDDDDDDDDDDDDDDDDDDDDDDDDDDDDDDDDDDDDDDDDDDDDDD
}----------------------------------------------------------------------------------D{DDDD}-o-{DDDDDDDDDDDDDDDDDDQZZZZZZZZZZZZZZZZZZZqDDDDQZZZZZZZZZZZZZZZZZZZZZZZZZZZZZZZqDDDDDDDDDDDDDDDDD
}Hoooo1EEEEEEEE----------------------------------------------------------------o----{DDDD}-o-{DDDDDDDDDDDDDDDDDD}-------------------{DDDD}-------------------------------{DDDDDDDDDDDDDDDDD
rGGGGGGGGGGGGGGGGR------------------------------------------------------------[=]---{DDDD}-o-{DDDDDDDDDDDDDDDDDD}-------------------{DDDD}-------------------------------{DDDDDDDDDDDDDDDDD
DDDDDDDDDDDDDDDDD}----oooo--------Booo----------------------------------------------{DDDD}-o-{DDDDDDDDDDDDDDDDDD}-------------------{DDDD}-------------------------------{DDDDDDDDDDDDDDDDD
DDDDDDDDDQZZZZZZZO--[=======]----[=====]-----------------------------------------oo-{DDDD}-o-{DDDDDDDDDDDDDDDDDD}-------------------{DDDD}-------------------------------{DDDDDDDDDDDDDDDDD
DDDDDDDDD}----------------------------------------------------------------------LGGGlDDDD}-o-{DDDDDDDDDDDDDDDDDD}-----------------CH{DDDD}-------------------------------{DDDDDDDDDDDDDDDDD
DDDDDDDDD}--------------------------------ooo------------------------------3----{DDDDDDDD}-o-{DDDDDDDDDDDDDDDDDD}---------------LGGGlDDDD}-------------------------------{DDDDDDDDDDDDDDDDD
DDDDDDDDD}------------------------------[=====]--------------------------LGGGGGGlDDDDDDDD}-o-{DDDDDDDDDDDDDDDDDD}-----oo---EEEEEIZZZZZZZZO-------------------------------{DDDDDDDDDDDDDDDDD
DDDDDDDDD}---------------------------------------------------------------{DDDDDDDDDDDDDDD}-o-{DDDDDDDDDDDDDDDDDD}----[==]--[===]-----------------------------------------{DDDDDDDDDDDDDDDDD
ZZZZZZZZZO--------------------------------------ooooo--------6-------oo--{DDDDDDDDDDDDDDD}-o-{DDDDDDDDDDDDDDDDDD}-----------------------------------------------2---F----{DDDDDDDDDDDDDDDDD
----------------------------------------------LGGGGGGGR---LGGGGR---LGGGGGlDDDDDDDDDDDDDDD}-o-{DDDDDDDDDDDDDDDDDD}--------1-------EEEEEEE-------B-------------LGGGGGGGGGGGlDDDDDDDDDDDDDDDDD
----------------------------------------------{DDDDDDD}---{DDDD}---{DDDDDDDDDDDDDDDDDDDDD}---{DDDDDDDDDDDDDDDDDDrGGGGGGGGGGGGGGGGGGGGGGGGGR---[=]----[==]----{DDDDDDDDDDDDDDDDDDDDDDDDDDDDD
----------------------------------------EEEE--{DDDDDDD}---{DDDD}---{DDDDDDDDDDDDDDDDDDDDD}---{DDDDDDDDDDDDDDDDDDDDDDDDDDDDDDDDDDDDDDDDDDDD}------------------{DDDDDDDDDDDDDDDDDDDDDDDDDDDDD
----------------------------------------LGGGGGlDDDDDDD}---{DDDD}---{DDDDDDDDDDQZZZZZZZZZZO---{DDDDDDDDDDDDDDDDDDDDDDDDDDDDDDDDDDDDDDDDDDDD}------------------{DDDDDDDDDDDDDDDDDDDDDDDDDDDDD
----------------------------------------{DDDDDDDDDDDDD}---{DDDD}---{DDDDDDDDDD}--------------{DDDDDDDDDDDDDDDDDDDDDDDDDDDDDDDDDDDDDDDDDDDD}------------------{DDDDDDDDDDDDDDDDDDDDDDDDDDDDD
GGGGGGGGR-2-----------B---------LGR--4--{DDDDDDDDDDDDD}---{DDDD}---{DDDDDDDDDD}--------------{DDDDDDDDDDDDDDDDDDDDDDDDDDDDDDDDDDDDDDDDDDDD}------------------{DDDDDDDDDDDDDDDDDDDDDDDDDDDDD
DDDDDDDDrGGGGGGR---[===]----LGGGlDrGGGGGlDDDDDDDDDDDDD}SSS{DDDD}SSS{DDDDDDDDDD}--------------{DDDDDDDDDDDDDDDDDDDDDDDDDDDDDDDDDDDDDDDDDDDD}------------------{DDDDDDDDDDDDDDDDDDDDDDDDDDDDD
DDDDDDDDDDDDDDD}------------{DDDDDDDDDDDDDDDDDDDDDDDDDrGGGlDDDDrGGGlDDDDDDDDDD}----------LGGGlDDDDDDDDDDDDDDDDDDDDDDDDDDDDDDDDDDDDDDDDDDDD}------------------{DDDDDDDDDDDDDDDDDDDDDDDDDDDDD
DDDDDDDDDDDDDDD}------------{DDDDDDDDDDDDDDDDDDDDDDDDDDDDDDDDDDDDDDDDDDDDDDDDD}-------LGGlDDDDDDDDDDDDDDDDDDDDDDDDDDDQZZZZZZZZZqDDDDDDDDDD}------------------{DDDDDDDDDDDDDDDDDDDDDDDDDDDDD
DDDDDDDDDDDDDDD}------------{DDDDDDDDDDDDDDDDDDDDDDDDDDDDDDDDDDQZZZZZZZZZZZZZZO-------{DDDDDDDDDDDDDDDDDDDDDDDDDDDDDD}---------{DDDDDDDDDD}------------------{DDDDDDDDDDDDDDDDDDDDDDDDDDDDD
DDDDDDDDDDDDDDD}------------{DDDDDDDDDDDDDDDDDDDDDDDDDDDDDDDDDD}----------------------IZZZZZZZZZZZZZZZZZZZZZZZZZZZZZZ}---------{DDDDDDDDDD}------------------{DDDDDDDDDDDDDDDDDDDDDDDDDDDDD
DDDDDDDDDDDDDDD}------------{DDDDDDDDDDDDDDDDDDDDDDDDDDDDDDDDDD}-----------------------------------------------------}--5-H----{DDDDDDDDDD}------------------{DDDDDDDDDDDDDDDDDDDDDDDDDDDDD
DDDDDDDDDDDDDDD}------------{DDDDDDDDDDDDDDDDDDDDDDDDDDDDDDDDDD}---Hoooooooo---------EEEE----------------------------rGGGGGG---{DDDDDDDDDD}------------------{DDDDDDDDDDDDDDDDDDDDDDDDDDDDD
DDDDDDDDDDDDDDD}------------{DDDDDDDDDDDDDDDDDDDDDDDDDDDDDDDDDD}---[==========]--LGGGGGGGGR---------oooo--------H--------------{DDDDDDDDDD}SSSSSSSSSSSSSSSSSS{DDDDDDDDDDDDDDDDDDDDDDDDDDDDD
DDDDDDDDDDDDDDD}------------{DDDDDDDDDDDDDDDDDDDDDDDDDDDDDDDDDD}-----------------{DDDDDDDD}--[==]--[=====]---4ooooooB----------{DDDDDDDDDDrGGGGGGGGGGGGGGGGGGlDDDDDDDDDDDDDDDDDDDDDDDDDDDDD
DDDDDDDDDDDDDDD}------------{DDDDDDDDDDDDDDDDDDDDDDDDDDDDDDDDDD}-----------------{DDDDDDDD}-----------------LGGGGGGGGR---LGGGGGlDDDDDDDDDDDDDDDDDDDDDDDDDDDDDDDDDDDDDDDDDDDDDDDDDDDDDDDDDDD
DDDDDDDDDDDDDDD}SSSSSSSSSSSS{DDDDDDDDDDDDDDDDDDDDDDDDDDDDDDDDDD}-----------------{DDDDDDDD}-----------------{DDDDDDDD}---{DDDDDDDDDDDDDDDDDDDDDDDDDDDDDDDDDDDDDDDDDDDDDDDDDDDDDDDDDDDDDDDDD
DDDDDDDDDDDDDDDrGGGGGGGGGGGGlDDDDDDDDDDDDDDDDDDDDDDDDDDDDDDDDDDrSSSSSSSSSSSSSSSSS{DDDDDDDD}-----------------{DDDDDDDD}---{DDDDDDDDDDDDDDDDDDDDDDDDDDDDDDDDDDDDDDDDDDDDDDDDDDDDDDDDDDDDDDDDD
DDDDDDDDDDDDDDDDDDDDDDDDDDDDDDDDDDDDDDDDDDDDDDDDDDDDDDDDDDDDDDDDGGGGGGGGGGGGGGGGGlDDDDDDDD}-----------------{DDDDDDDD}---{DDDDDDDDDDDDDDDDDDDDDDDDDDDDDDDDDDDDDDDDDDDDDDDDDDDDDDDDDDDDDDDDD
DDDDDDDDDDDDDDDDDDDDDDDDDDDDDDDDDDDDDDDDDDDDDDDDDDDDDDDDDDDDDDDDDDDDDDDDDDDDDDDDDDDDDDDDDD}-----------------{DDDDDDDD}---{DDDDDDDDDDDDDDDDDDDDDDDDDDDDDDDDDDDDDDDDDDDDDDDDDDDDDDDDDDDDDDDDD
DDDDDDDDDDDDDDDDDDDDDDDDDDDDDDDDDDDDDDDDDDDDDDDDDDDDDDDDDDDDDDDDDDDDDDDDDDDDDDDDDDDDDDDDDD}-----------------{DDDDDDDD}---{DDDDDDDDDDDDDDDDDDDDDDDDDDDDDDDDDDDDDDDDDDDDDDDDDDDDDDDDDDDDDDDDD
DDDDDDDDDDDDDDDDDDDDDDDDDDDDDDDDDDDDDDDDDDDDDDDDDDDDDDDDDDDDDDDDDDDDDDDDDDDDDDDDDDDDDDDDDD}SSSSSSSSSSSSSSSSS{DDDDDDDD}---{DDDDDDDDDDDDDDDDDDDDDDDDDDDDDDDDDDDDDDDDDDDDDDDDDDDDDDDDDDDDDDDDD
DDDDDDDDDDDDDDDDDDDDDDDDDDDDDDDDDDDDDDDDDDDDDDDDDDDDDDDDDDDDDDDDDDDDDDDDDDDDDDDDDDDDDDDDDDrGGGGGGGGGGGGGGGGGlDDDDDDDD}---{DDDDDDDDDDDDDDDDDDDDDDDDDDDDDDDDDDDDDDDDDDDDDDDDDDDDDDDDDDDDDDDDD
DDDDDDDDDDDDDDDDDDDDDDDDDDDDDDDDDDDDDDDDDDDDDDDDDDDDDDDDDDDDDDDDDDDDDDDDDDDDDDDDDDDDDDDDDDDDDDDDDDDDDDDDDDDDDDDDDDDDD}---{DDDDDDDDDDDDDDDDDDDDDDDDDDDDDDDDDDDDDDDDDDDDDDDDDDDDDDDDDDDDDDDDD
DDDDDDDDDDDDDDDDDDDDDDDDDDDDDDDDDDDDDDDDDDDDDDDDDDDDDDDDDDDDDDDDDDDDDDDDDDDDDDDDDDDDDDDDDDDDDDDDDDDDDDDDDDDDDDDDDDDDD}SSS{DDDDDDDDDDDDDDDDDDDDDDDDDDDDDDDDDDDDDDDDDDDDDDDDDDDDDDDDDDDDDDDDD
DDDDDDDDDDDDDDDDDDDDDDDDDDDDDDDDDDDDDDDDDDDDDDDDDDDDDDDDDDDDDDDDDDDDDDDDDDDDDDDDDDDDDDDDDDDDDDDDDDDDDDDDDDDDDDDDDDDDDrGGGlDDDDDDDDDDDDDDDDDDDDDDDDDDDDDDDDDDDDDDDDDDDDDDDDDDDDDDDDDDDDDDDDD
DDDDDDDDDDDDDDDDDDDDDDDDDDDDDDDDDDDDDDDDDDDDDDDDDDDDDDDDDDDDDDDDDDDDDDDDDDDDDDDDDDDDDDDDDDDDDDDDDDDDDDDDDDDDDDDDDDDDDDDDDDDDDDDDDDDDDDDDDDDDDDDDDDDDDDDDDDDDDDDDDDDDDDDDDDDDDDDDDDDDDDDDDDD
DDDDDDDDDDDDDDDDDDDDDDDDDDDDDDDDDDDDDDDDDDDDDDDDDDDDDDDDDDDDDDDDDDDDDDDDDDDDDDDDDDDDDDDDDDDDDDDDDDDDDDDDDDDDDDDDDDDDDDDDDDDDDDDDDDDDDDDDDDDDDDDDDDDDDDDDDDDDDDDDDDDDDDDDDDDDDDDDDDDDDDDDDDD
DDDDDDDDDDDDDDDDDDDDDDDDDDDDDDDDDDDDDDDDDDDDDDDDDDDDDDDDDDDDDDDDDDDDDDDDDDDDDDDDDDDDDDDDDDDDDDDDDDDDDDDDDDDDDDDDDDDDDDDDDDDDDDDDDDDDDDDDDDDDDDDDDDDDDDDDDDDDDDDDDDDDDDDDDDDDDDDDDDDDDDDDDDD
