-----------------------------------------------------------------------------------------
-----------------------------------------------------------------------------------------
-----------------------------------------------------------------------------------------
-----------------------------------------------------------------------------------------
-----------------------------------------------------------------------------------------
-----------------------------------------------------------------------------------------
-----------------------------------------------------------------------------------------
-----------------------------------------------------------------------------------------
--------------D--------------------------------------------------------------------------
------------DDDD-------------------------------------------------------------------------
-----------------------------------------------------------------------------------------
---P------------oooo---------------------------------------------------------------------
----------------DDDD---DDD---------------------------------------------------------------
----------o-HHH--H-----------------------------------------------------------------------
---------CLGGR-EEEEESSLR--EEE---------GGGGGGGGGGGGGGGGGGGGGGGGGGGGGGGGGGGGGGGGGGGGGGGGGGG
GGGGGGGGGGlDDrGGGGGGGGlrGGGGGGGGGGGGGGGDDDDDDDDDDDDDDDDDDDDDDDDDDDDDDDDDDDDDDDDDDDDDDDDDD
DDDDDDDDDDDDDDDDDDDDDDDDDDDDDDDDDDDDDDDDDDDDDDDDDDDDDDDDDDDDDDDDDDDDDDDDDDDDDDDDDDDDDDDDD